Ariadna	Alcalá	Martínez
Laura	Calvo	Ascaso
Sandra	Díaz	Belmonte
Aarón	Gallego	Herrador
Aleix	García	Uréndez
Carolina	Giménez	Carbonell
Yeray	Gómez	Bono
Luis	Jiménez	Navarro
Paola Andrea	Laura	Valda
Víctor	Melguizo	Cadenas
Jordi	Palomo	Dalmau
Irene	Pizarro	Mira
Hajar	Regbaoui	Regbaoui
Alex	Rico	Rodríguez
Carlos	Rodríguez	Fernández
Jénifer	Ruiz	Franco
Aitor	Saldaña	Chaparro
Sheima	Saloui	Rubio
Salvador Albert	Sánchez	Campos
Lydia	Silva	Sánchez